11011111111111111111
11000001111111111111
11011111110000011011
11000000001111011011
11010111101111000011
11000011000000011111
11110111110111111111
11110111010111111111
11110000000000000011
11111111110111111111